#############
#A      #   #
# # # # # # #
# #         #
#   ### ## ##
# #      #  #
#  # ###   ##
# ##   B #  #
#    # # # ##
# # ##     ##
#    # # # ##
## #        #
#############